1 1 1 1 1 1 2 3 3 4 1 1 1 1 1 1
1 1 1 1 1 1 5 6 6 7 1 1 1 1 1 1
1 1 1 1 1 1 5 6 6 7 1 1 1 1 1 1
1 1 1 1 1 1 5 6 6 7 1 1 1 1 1 1
1 1 1 1 1 1 5 6 6 7 1 1 1 1 1 1
1 1 1 1 1 1 5 6 6 7 1 1 1 1 1 1
1 1 1 1 1 1 5 6 6 7 1 1 1 1 1 1
1 1 1 1 1 1 5 6 6 7 1 1 1 1 1 1
1 1 1 1 1 1 5 6 6 7 1 1 1 1 1 1
1 1 1 1 1 1 5 6 6 7 1 1 1 1 1 1
1 1 1 1 1 1 5 6 6 7 1 1 1 1 1 1
1 1 1 1 1 1 5 6 6 7 1 1 1 1 1 1
1 1 1 1 1 1 8 9 9 10 1 1 1 1 1 1
1 1 1 1 1 1 1 1 1 1 1 1 1 1 1 1
1 1 1 1 1 1 1 1 1 1 1 1 1 1 1 1
1 1 1 1 1 1 1 1 1 1 1 1 1 1 1 1
